17 14
1 1 1 1 1 1 1 1 1 1 1 1 1 1 1 1 1
8 8 8 1 1 1 1 1 1 1 1 1 1 1 1 1 1
8 8 8 1 1 1 1 1 1 1 1 1 1 1 8 8 8
8 8 8 1 1 1 1 1 1 1 1 1 1 1 8 8 8
8 8 8 1 1 1 1 1 1 1 1 1 1 1 8 8 8
7 1 1 1 1 1 1 1 1 1 1 1 1 1 1 1 7
7 1 1 1 1 1 1 1 1 1 1 1 1 1 1 1 7
7 1 1 1 1 1 1 1 1 1 1 1 1 1 1 1 7
4 11 11 6 1 1 1 1 1 1 1 1 1 1 5 11 7
7 1 1 1 1 1 1 1 1 1 1 1 1 1 1 1 7
7 1 1 1 1 1 1 1 1 1 1 1 1 1 1 1 7
7 1 1 1 1 1 1 1 1 1 1 1 1 1 1 1 7
16 16 16 16 16 16 16 16 16 16 16 16 16 16 16 16 16
16 16 16 16 16 16 16 16 16 16 16 16 16 16 16 16 16