50 18
1 1 1 1 1 1 1 1 1 1 1 1 1 1 1 1 1 1 1 1 1 1 0 2 16 2 1 1 1 1 1 1 1 1 1 1 1 8 8 8 8 8 8 8 8 1 1 1 1 1
1 1 1 1 1 1 1 1 1 1 1 1 1 1 1 1 1 1 1 1 1 1 2 16 2 16 1 1 1 1 1 1 1 1 1 1 8 8 1 1 1 1 1 1 8 8 1 1 1 1
1 1 1 1 1 1 1 1 1 1 1 1 1 1 1 1 1 1 1 1 1 1 2 2 16 2 1 1 1 1 1 1 1 1 1 1 8 8 1 8 8 8 8 1 8 8 8 1 1 1
1 1 1 1 1 1 1 1 1 1 1 1 1 1 1 1 1 1 1 1 1 1 16 16 2 2 1 1 1 1 1 1 1 1 1 1 1 1 1 8 7 7 8 1 8 8 8 1 1 1
1 1 1 1 1 1 1 1 1 1 1 1 1 1 1 2 2 1 1 1 1 1 16 16 16 16 1 1 1 1 1 1 1 1 1 1 1 1 1 1 8 7 8 1 1 1 1 1 1 1
1 1 1 1 1 1 1 1 1 1 1 1 1 1 1 2 16 1 1 1 1 1 16 16 16 16 1 1 1 1 1 1 1 1 1 1 1 1 1 1 1 7 8 1 1 1 1 1 1 1
1 1 1 1 1 1 1 1 1 1 1 1 1 1 1 16 2 1 1 1 1 1 16 16 16 16 1 1 1 1 1 8 8 8 8 1 1 1 1 5 11 7 7 6 1 1 1 1 1 1
1 1 1 1 1 1 1 1 1 1 1 1 1 1 1 16 16 1 1 1 1 1 16 16 16 16 1 1 1 1 8 8 8 8 8 8 1 1 1 1 1 1 7 1 1 1 1 1 1 1
1 1 1 1 1 1 1 1 1 1 1 1 1 1 1 16 16 16 1 1 1 1 16 16 16 16 2 1 1 1 8 8 8 8 8 8 1 1 1 5 11 11 7 1 1 1 1 1 1 1
1 1 1 1 1 1 1 1 1 1 1 1 1 1 1 16 16 16 1 1 1 1 16 16 16 2 16 2 1 1 1 8 8 8 8 1 1 1 1 1 1 1 7 11 6 1 1 1 1 1
1 1 1 1 8 8 8 1 1 1 1 1 1 1 1 16 16 16 1 1 1 1 16 16 16 16 16 2 1 1 1 1 1 7 1 1 1 1 1 1 5 11 7 1 1 1 1 1 1 1
1 1 1 8 8 8 8 8 1 1 1 1 1 1 1 16 16 16 1 1 1 1 16 16 16 16 16 16 1 1 5 11 11 4 1 1 1 1 1 1 1 1 7 1 1 1 1 1 1 1
1 1 1 1 1 1 7 1 1 1 1 1 1 1 1 16 16 16 16 1 1 1 16 16 16 16 16 16 1 1 1 1 1 7 1 1 1 1 1 1 1 1 7 1 1 1 1 1 1 1
1 1 1 1 1 1 7 1 1 1 1 1 1 1 1 16 16 16 16 1 1 1 16 16 16 16 16 1 1 1 1 1 1 7 0 0 14 14 14 14 0 0 0 0 0 0 0 0 0 0
1 1 1 5 11 11 7 6 1 1 1 1 1 1 1 16 16 16 16 1 1 1 1 1 16 16 16 1 1 16 14 14 14 0 2 2 2 2 2 2 2 2 2 2 2 2 2 2 2 2
1 1 1 1 1 1 7 1 1 1 1 1 1 1 1 16 16 16 16 1 1 1 1 1 1 1 1 1 16 16 15 15 15 2 2 2 2 16 2 2 16 2 2 2 16 2 16 16 16 16
0 0 0 0 0 0 0 0 14 14 14 14 14 14 14 16 16 16 16 16 16 16 16 1 1 1 1 1 16 2 2 16 2 2 2 2 16 2 16 2 16 16 2 2 16 2 2 2 16 2
2 2 2 2 2 2 2 2 15 15 15 15 15 15 15 16 16 16 16 16 16 16 16 16 16 16 16 16 16 16 16 2 16 16 16 2 2 16 2 2 2 16 16 2 2 2 2 2 16 2