34 14
1 1 1 1 1 1 1 1 1 1 1 1 1 1 1 1 1 1 1 1 1 1 1 1 1 1 1 1 1 1 1 1 1 1
1 1 1 1 1 1 1 1 1 1 1 1 1 1 1 1 1 1 1 1 1 1 1 1 1 1 1 1 1 1 1 1 1 1
1 1 1 1 1 1 1 1 1 1 1 1 1 1 1 1 1 1 1 8 8 8 1 1 1 1 1 1 1 1 1 1 1 1
1 3 1 1 1 1 1 1 1 1 1 1 1 1 1 1 1 1 8 8 8 8 8 1 1 1 1 1 1 1 1 1 1 1
1 1 1 1 1 1 1 1 1 1 1 1 1 1 1 1 1 1 8 8 8 8 8 1 1 1 17 1 1 1 1 1 1 1
1 1 1 1 1 1 1 1 1 1 1 1 1 1 1 1 1 1 1 1 7 1 1 1 1 1 1 1 1 1 1 1 1 1
1 1 1 1 1 1 1 8 8 8 8 1 1 1 1 1 1 5 11 11 12 1 1 1 1 1 1 1 1 1 1 1 1 1
1 1 1 1 1 1 5 8 8 8 8 1 1 1 1 1 1 1 1 1 13 11 6 1 1 1 1 1 1 1 1 1 1 1
1 1 1 1 1 1 1 1 7 7 1 1 1 1 1 1 1 1 1 1 7 1 1 1 1 1 1 1 1 0 1 1 1 1
1 1 1 1 1 5 11 11 4 7 1 1 1 1 1 1 1 1 1 1 7 1 1 1 1 1 1 1 0 0 0 1 1 1
1 1 1 1 1 1 1 1 7 7 1 1 1 1 1 1 1 1 0 0 0 0 0 1 1 1 9 0 0 0 0 0 1 10
1 1 1 1 1 1 1 1 7 7 10 1 1 1 1 1 1 1 0 0 0 0 0 0 0 0 0 0 0 0 0 0 0 0
0 0 0 0 0 0 0 0 0 0 0 0 0 14 14 14 14 0 0 0 0 0 0 0 0 0 0 0 0 0 0 0 0 0
2 2 2 2 2 2 2 2 2 2 2 2 2 16 16 16 16 2 2 2 2 2 2 2 2 2 2 2 2 2 2 2 2 2